12 48
44 44 44 44 44 44 44 44 44 44 44 44 44 44 44 44 44 44 44 44 44 44 44 44 44 44 44 44 44 44 44 44 44 44 44 44 44 44 44 44 44 44 44 44 44 44 44 44 
43 43 46 45 46 45 46 45 46 45 46 45 43 43 43 43 43 43 46 45 46 45 46 45 46 45 46 45 43 43 43 43 43 43 43 43 43 43 43 43 49 10 9 13 9 13 14 44 
47 48 47 48 47 48 47 48 47 48 47 48 46 45 46 45 47 48 47 48 47 48 47 48 47 48 47 48 43 43 43 43 43 43 43 43 43 43 43 43 44 44 6 11 6 11 15 44 
40 39 40 39 40 39 40 39 40 39 40 39 47 48 47 48 40 39 40 39 40 39 40 39 40 39 40 39 46 45 46 45 46 45 46 45 46 45 46 45 44 7 8 11 8 11 16 44 
41 42 37 38 47 48 47 48 47 48 47 48 47 48 47 48 47 48 37 38 47 48 47 48 47 48 47 48 47 48 47 48 47 48 47 48 37 38 37 38 44 6 5 12 6 11 17 44 
40 39 36 35 40 39 40 39 40 39 40 39 40 39 40 39 40 39 36 35 40 39 40 39 40 39 40 39 40 39 40 39 40 39 40 39 36 35 36 35 44 4 5 44 8 11 14 44 
37 38 44 44 37 38 37 38 37 38 37 38 37 38 37 38 37 38 44 44 37 38 37 38 37 38 37 38 37 38 37 38 37 38 37 38 44 44 44 44 44 6 5 44 6 11 16 44 
36 35 29 28 36 35 36 35 36 35 36 35 36 35 36 35 36 35 29 28 36 35 36 35 36 35 36 35 36 35 36 35 36 35 36 35 29 28 44 44 44 4 5 44 8 11 15 44 
34 33 27 26 44 44 34 33 34 33 44 44 34 33 44 44 34 33 27 26 44 44 34 33 34 33 44 44 34 33 44 44 44 44 44 44 27 26 44 44 44 4 3 44 4 18 15 44 
32 31 23 23 30 30 32 31 32 31 30 30 32 31 30 30 32 31 23 23 30 30 32 31 32 31 30 30 32 31 30 30 30 30 25 24 23 23 22 21 20 2 1 44 1 19 16 44 
44 44 44 44 44 44 44 44 44 44 44 44 44 44 44 44 44 44 44 44 44 44 44 44 44 44 44 44 44 44 44 44 44 44 44 44 44 44 44 44 44 44 44 44 44 44 44 44 
44 44 44 44 44 44 44 44 44 44 44 44 44 44 44 44 44 44 44 44 44 44 44 44 44 44 44 44 44 44 44 44 44 44 44 44 44 44 44 44 44 44 44 44 44 44 44 44