47 128
0 0 0 0 0 0 0 0 0 0 0 0 0 0 0 0 0 0 0 0 0 0 0 0 0 0 0 0 0 0 0 0 0 0 0 0 0 0 0 0 0 0 0 0 0 0 0 0 0 0 0 0 0 0 0 0 0 0 0 0 0 0 0 0 0 0 0 0 0 0 0 0 0 0 0 0 0 0 0 0 0 0 0 0 0 0 0 0 0 0 0 0 0 0 0 0 0 0 0 0 0 0 0 0 0 0 0 0 0 0 0 0 0 0 0 0 0 0 0 0 0 0 0 0 0 0 0 0 
0 0 0 0 0 0 0 0 0 0 0 0 0 0 0 0 0 0 0 0 0 0 0 0 0 0 0 0 0 0 0 0 0 0 0 0 0 0 0 0 0 0 0 0 0 0 0 0 0 0 0 0 0 0 0 0 0 0 0 0 0 0 0 0 0 0 0 0 0 0 0 0 0 0 0 0 0 0 0 0 0 0 0 0 0 0 0 0 0 0 0 0 0 0 0 0 0 0 0 0 0 0 0 0 0 0 0 0 0 0 0 0 0 0 0 0 0 0 0 0 0 0 0 0 0 0 0 0 
0 0 0 0 0 0 0 0 0 0 0 0 0 0 0 0 0 0 0 0 0 0 0 0 0 0 0 0 0 0 0 0 0 0 0 0 0 0 0 0 0 0 0 0 0 0 0 0 0 0 0 0 0 0 0 0 0 0 0 0 0 0 0 0 0 0 0 0 0 0 0 0 0 0 0 0 0 0 0 0 0 0 0 0 0 0 0 0 0 0 0 0 0 0 0 0 0 0 0 0 0 0 0 0 0 0 0 0 0 0 0 0 0 0 0 0 0 0 0 0 0 0 0 0 0 0 0 0 
1 1 2 2 2 2 3 4 2 2 2 2 5 6 7 8 7 8 9 10 11 12 9 10 13 14 9 10 13 14 9 10 13 14 9 10 13 14 9 10 13 14 9 10 15 16 1 1 2 17 18 18 18 18 18 18 18 18 19 2 2 2 2 2 2 2 2 2 2 2 2 2 2 2 2 2 2 2 2 2 2 2 2 2 2 2 2 2 2 2 2 2 2 2 2 2 2 2 2 2 2 2 2 2 2 2 2 2 2 2 2 2 2 2 2 2 2 2 2 2 2 2 2 2 2 2 2 2 
1 1 2 2 20 21 22 22 20 21 2 2 5 6 23 24 23 24 25 26 27 28 25 26 29 30 25 26 29 30 25 26 29 30 25 26 29 30 25 26 29 30 25 26 31 31 1 1 2 0 0 0 0 0 0 0 0 0 32 2 2 2 2 2 2 2 2 2 2 2 2 2 2 2 2 2 2 2 2 2 2 2 2 2 2 2 2 2 2 2 2 2 2 2 2 2 2 2 2 2 2 2 2 2 2 2 2 2 2 2 2 2 2 2 2 2 2 2 2 2 2 2 2 2 2 2 2 2 
1 1 2 2 33 34 22 22 33 34 2 2 5 6 15 16 15 16 35 36 5 6 35 36 5 6 35 36 5 6 35 36 5 6 35 36 5 6 35 36 5 6 35 36 31 31 1 1 2 0 0 0 0 0 0 0 0 0 32 2 2 2 2 2 2 2 2 2 2 2 2 2 2 2 2 2 2 2 2 2 2 2 2 2 2 2 2 2 2 2 2 2 2 2 2 2 2 2 2 2 2 2 2 2 2 2 2 2 2 2 2 2 2 2 2 2 2 2 2 2 2 2 2 2 2 2 2 2 
1 1 20 21 37 38 22 22 37 38 20 21 5 6 31 31 31 31 39 40 5 6 39 40 5 6 39 40 5 6 39 40 5 6 39 40 5 6 39 40 5 6 39 40 31 31 1 1 2 0 0 0 0 0 0 0 0 0 32 2 2 2 2 2 2 2 2 2 2 2 2 2 2 2 2 2 2 2 2 2 2 2 2 2 2 2 2 2 2 2 2 2 2 2 2 2 2 2 2 2 2 2 2 2 2 2 2 2 2 2 2 2 2 2 2 2 2 2 2 2 2 2 2 2 2 2 2 2 
41 41 33 34 37 38 42 42 37 38 33 34 5 6 31 31 31 31 43 44 5 6 43 44 5 6 43 44 5 6 43 44 5 6 43 44 5 6 43 44 5 6 43 44 31 31 1 1 2 0 0 0 0 0 0 0 0 0 45 17 17 17 17 17 17 17 17 17 17 17 17 17 17 17 17 17 17 17 17 17 17 17 17 17 17 17 17 17 17 17 17 17 17 17 17 17 17 17 17 17 17 17 17 17 17 17 17 17 17 17 17 17 17 17 17 17 17 17 17 17 17 17 17 17 46 2 2 2 
47 48 37 38 37 38 2 2 37 38 37 38 5 6 31 31 31 31 49 44 5 6 49 44 5 6 49 44 5 6 49 44 5 6 49 44 5 6 49 44 5 6 49 44 31 31 1 1 2 0 0 0 0 0 0 0 0 0 0 0 0 0 0 0 0 0 0 0 0 0 0 0 0 0 0 0 0 0 0 0 0 0 0 0 0 0 0 0 0 0 0 0 0 0 0 0 0 0 0 0 0 0 0 0 0 0 0 0 0 0 0 0 0 0 0 0 0 0 0 0 0 0 0 0 50 2 2 2 
51 52 53 54 53 54 55 56 53 54 53 54 5 6 57 57 57 57 58 59 60 61 58 59 60 61 58 59 60 61 58 59 60 61 58 59 60 61 58 59 60 61 58 59 31 31 1 1 2 0 0 0 0 0 0 0 0 0 0 0 0 0 0 0 0 0 0 0 0 0 0 0 0 0 0 0 0 0 0 0 0 0 0 0 0 0 0 0 0 0 0 0 0 0 0 0 0 0 0 0 0 0 0 0 0 0 0 0 0 0 0 0 0 0 0 0 0 0 0 0 0 0 0 0 50 2 2 2 
62 63 64 65 64 65 66 67 64 65 64 65 60 61 41 41 41 41 41 41 41 41 41 41 41 41 41 41 41 41 41 41 41 41 41 41 41 41 41 41 41 41 41 41 68 57 1 1 2 0 0 0 0 0 0 0 0 0 0 0 0 0 0 0 0 0 0 0 0 0 0 0 0 0 0 0 0 0 0 0 0 0 0 0 0 0 0 0 0 0 0 0 0 0 0 0 0 0 0 0 0 0 0 0 0 0 0 0 0 0 0 0 0 0 0 0 0 0 0 0 0 0 0 0 50 2 2 2 
41 41 41 41 41 41 41 41 41 41 41 41 41 41 69 69 69 69 70 71 72 72 70 71 72 72 70 71 72 72 70 71 72 72 70 71 72 72 70 71 72 72 31 73 74 41 1 1 2 0 0 0 0 0 0 0 0 0 0 0 0 0 0 0 0 0 0 0 0 0 0 0 0 0 0 0 0 0 0 0 0 0 0 0 0 0 0 0 0 0 0 0 0 0 0 0 0 0 0 0 0 0 0 0 0 0 0 0 0 0 0 0 0 0 0 0 0 0 0 0 0 0 0 0 50 2 2 2 
23 24 23 24 23 24 23 24 23 24 23 24 23 24 23 24 23 24 25 26 29 30 25 26 29 30 25 26 29 30 25 26 29 30 25 26 29 30 25 26 29 30 75 76 31 31 1 1 2 0 0 0 0 0 0 0 0 0 0 0 0 0 0 0 0 0 0 0 0 0 0 0 0 0 0 0 0 0 0 0 0 0 0 0 0 0 0 0 0 0 0 0 0 0 0 0 0 0 0 0 0 0 0 0 0 0 0 0 0 0 0 0 0 0 0 0 0 0 0 0 0 0 0 0 50 2 2 2 
77 78 77 78 77 78 77 78 77 78 77 78 77 78 77 78 77 78 2 2 60 61 2 2 60 61 2 2 60 61 2 2 60 61 2 2 60 61 2 2 60 61 79 57 57 57 1 1 2 2 2 2 2 2 2 2 2 2 2 2 2 2 2 2 2 2 2 2 2 2 2 2 2 2 2 2 2 2 2 2 2 2 2 2 2 2 2 2 2 2 2 2 2 2 2 2 2 0 0 0 0 0 0 0 0 0 0 0 0 0 0 0 0 0 0 0 0 0 0 0 0 0 0 0 50 2 2 2 
1 1 9 10 13 14 9 10 13 14 9 10 13 14 9 10 80 81 2 2 5 6 2 2 5 6 2 2 5 6 2 2 5 6 2 2 5 6 2 2 31 73 82 81 83 84 1 1 1 1 5 6 85 86 5 6 87 88 5 6 85 86 5 6 89 90 31 31 31 31 91 92 87 88 5 6 93 94 5 6 31 31 5 6 31 31 5 6 87 88 5 6 95 96 1 1 2 0 0 0 0 0 0 0 0 0 0 0 0 0 0 0 0 0 0 0 0 0 0 0 0 0 0 0 50 2 2 2 
1 1 25 26 29 30 25 26 29 30 25 26 29 30 25 26 89 97 2 2 60 61 2 2 60 61 2 2 60 61 2 2 60 61 2 2 60 61 2 2 98 79 89 97 99 100 1 1 1 1 5 6 31 31 5 6 101 102 5 6 31 31 5 6 103 104 31 31 31 31 31 31 101 102 5 6 103 104 5 6 31 31 5 6 31 31 60 61 101 102 5 6 105 106 1 1 2 0 0 0 0 0 0 0 0 0 0 0 0 0 0 0 0 0 0 0 0 0 0 0 0 0 0 0 50 2 2 2 
1 1 107 107 5 6 107 107 5 6 107 107 5 6 2 2 41 41 41 41 41 41 41 41 41 41 41 41 41 41 41 41 41 41 41 41 41 41 41 41 41 41 41 41 41 41 41 41 41 41 5 6 83 84 5 6 95 96 5 6 83 84 5 6 91 92 31 31 87 88 83 84 85 86 5 6 108 109 5 6 83 84 5 6 87 88 41 0 110 96 5 6 111 112 1 1 2 0 0 0 0 0 0 0 0 0 0 0 0 0 0 0 0 0 0 0 0 0 0 0 0 0 0 0 50 2 2 2 
1 1 113 113 5 6 113 113 5 6 113 113 5 6 2 2 31 31 25 26 29 30 25 26 29 30 25 26 29 30 25 26 29 30 25 26 29 30 25 26 5 6 31 31 31 31 103 104 47 48 5 6 99 100 60 61 99 100 60 61 99 100 60 61 31 31 31 31 101 102 99 100 31 31 5 6 105 106 60 61 99 100 60 61 101 102 5 6 99 100 60 61 89 97 1 1 2 0 0 0 0 0 0 0 0 0 0 0 0 0 0 0 0 0 0 0 0 0 0 0 0 0 0 0 50 2 2 2 
1 1 113 113 5 6 113 113 5 6 113 114 60 61 41 41 83 84 2 2 5 6 2 2 5 6 2 2 5 6 2 2 5 6 107 107 5 6 107 107 5 6 31 31 80 81 108 109 51 52 5 6 41 41 41 41 41 41 41 41 41 41 41 41 31 31 31 31 85 115 41 41 83 84 5 116 117 118 41 41 41 41 41 41 119 120 5 116 41 41 41 41 41 41 1 1 2 0 0 0 0 0 0 0 0 0 0 0 0 0 0 0 0 0 0 0 0 0 0 0 0 0 0 0 50 2 2 2 
1 1 113 113 5 6 113 113 5 6 121 122 41 41 31 31 105 106 2 2 5 6 2 2 5 6 2 2 5 6 2 2 5 6 113 113 5 6 113 113 5 6 31 31 89 97 99 100 62 63 60 61 103 104 29 123 25 26 29 30 25 26 29 30 31 31 31 31 31 31 29 30 105 106 27 28 25 26 29 30 25 26 5 6 89 97 27 28 25 26 29 30 25 26 1 1 2 0 0 0 0 0 0 0 0 0 0 0 0 0 0 0 0 0 0 0 0 0 0 0 0 0 0 0 50 2 2 2 
1 1 113 113 5 6 113 113 60 61 124 81 83 84 83 84 111 112 2 2 5 6 2 2 5 6 2 2 5 6 2 2 5 6 113 113 5 6 113 113 5 6 57 57 2 1 1 1 1 1 41 41 125 126 5 127 128 128 5 6 128 128 5 6 80 81 87 88 83 84 5 6 89 97 5 6 129 130 5 6 131 132 5 6 41 41 5 6 131 132 5 6 131 132 1 1 2 0 0 0 0 0 0 0 0 0 0 0 0 0 0 0 0 0 0 0 0 0 0 0 0 0 0 0 50 2 2 2 
1 1 64 65 60 61 64 65 2 1 89 97 99 100 99 100 89 97 2 2 60 61 2 2 60 61 2 2 60 61 2 2 5 6 113 113 5 6 113 113 5 6 1 1 1 1 1 1 1 1 27 28 101 102 5 6 31 31 5 6 31 31 60 61 89 97 101 102 99 100 60 61 133 134 60 61 89 97 60 61 99 100 60 61 99 100 60 61 99 100 60 61 99 100 1 1 2 0 0 0 0 0 0 0 0 0 0 0 0 0 0 0 0 0 0 0 0 0 0 0 0 0 0 0 50 2 2 2 
1 1 41 41 41 41 41 41 41 41 41 41 41 41 41 41 41 41 41 41 41 41 41 41 41 41 41 41 41 41 1 1 5 6 113 113 5 6 113 113 5 6 1 1 1 1 1 1 1 1 5 6 85 135 60 61 57 136 60 61 70 71 41 41 41 41 93 137 41 41 41 41 138 139 41 41 41 41 41 41 41 41 41 41 41 41 41 41 41 41 41 41 41 41 1 1 2 0 0 0 0 0 0 0 0 0 0 0 0 0 0 0 0 0 0 0 0 0 0 0 0 0 0 0 140 141 142 2 
1 1 23 24 23 24 23 24 23 24 23 24 23 24 23 24 23 24 23 24 23 24 23 24 23 24 23 24 23 24 1 1 60 61 64 65 60 61 64 65 60 61 1 1 1 1 1 1 1 1 5 6 75 76 41 41 103 143 41 41 25 26 29 30 25 26 2 2 25 26 29 30 2 2 29 30 25 26 29 30 25 26 29 30 25 26 29 30 25 26 29 30 25 26 1 1 2 0 0 0 0 0 0 0 0 0 0 0 0 0 0 0 0 0 0 0 0 0 0 0 0 0 0 0 0 0 144 2 
1 1 77 78 77 78 77 78 77 78 77 78 77 78 77 78 77 78 77 78 77 78 77 78 77 78 77 78 77 78 1 1 1 1 1 1 1 1 1 1 1 1 1 1 1 1 1 1 1 1 5 6 145 31 27 146 91 92 27 146 128 128 5 6 128 128 147 148 128 128 149 150 128 128 5 6 151 152 5 6 128 128 5 6 128 128 5 6 128 128 5 6 128 128 41 41 2 2 2 2 2 2 2 2 2 2 2 2 2 2 2 2 2 2 2 2 2 2 2 2 2 2 2 2 2 2 2 2 
2 2 2 2 2 2 2 2 2 2 2 2 2 2 2 2 2 2 2 2 2 2 2 2 2 2 2 2 2 2 2 2 2 2 2 2 2 2 2 2 2 2 2 2 2 2 2 2 1 1 5 6 76 31 5 6 31 31 5 6 83 84 5 6 31 31 5 6 31 31 31 31 87 88 5 6 85 86 5 6 31 31 5 6 31 31 5 6 31 31 5 6 31 31 5 6 41 84 93 94 91 92 5 6 83 84 153 154 85 86 31 31 5 6 87 88 85 86 5 6 83 84 87 88 85 86 1 1 
2 2 2 2 2 2 2 2 2 2 2 2 2 2 2 2 2 2 2 2 2 2 2 2 2 2 2 2 2 2 2 2 2 2 2 2 2 2 2 2 2 2 2 2 2 2 2 2 1 1 60 155 31 31 5 6 31 31 5 6 105 106 5 6 31 31 60 61 31 31 31 31 101 102 5 6 31 31 5 6 31 31 5 6 31 31 5 6 31 31 5 6 31 31 5 6 47 48 103 104 31 31 5 6 105 106 101 102 31 31 31 31 5 6 101 102 31 31 5 6 105 106 101 102 31 31 1 1 
2 2 2 2 2 2 2 2 2 2 2 2 2 2 2 2 2 2 2 2 2 2 2 2 2 2 2 2 2 2 2 2 2 2 2 2 2 2 2 2 2 2 2 2 2 2 2 2 1 1 41 41 83 84 5 6 83 84 5 6 111 112 5 6 83 84 41 41 83 84 80 81 156 120 5 6 83 84 5 6 83 84 5 6 80 81 5 6 80 81 5 6 83 84 5 6 51 52 91 92 87 88 5 6 111 112 85 86 83 84 83 84 5 6 93 94 31 31 5 6 111 112 95 96 31 31 1 1 
2 2 2 2 2 2 2 2 2 2 2 2 2 2 2 2 2 2 2 2 2 2 2 2 2 2 2 2 2 2 2 2 2 2 2 2 2 2 2 2 2 2 2 2 2 2 2 2 1 1 60 61 99 100 60 61 99 100 60 61 89 97 60 61 99 100 5 6 99 100 89 97 89 97 60 61 99 100 60 61 99 100 60 61 89 97 60 61 89 97 60 61 99 100 60 61 62 63 31 31 101 102 60 61 89 97 31 31 99 100 99 100 60 61 103 104 31 31 60 61 89 97 99 100 31 31 1 1 
2 2 2 2 2 2 2 2 2 2 2 2 2 2 2 2 2 2 2 2 2 2 2 2 2 2 2 2 2 2 2 2 2 2 2 2 2 2 2 2 2 2 2 2 2 2 2 2 1 1 41 41 41 41 41 41 41 41 41 41 41 41 41 41 41 41 157 158 41 41 41 41 41 41 41 41 41 41 41 41 41 41 41 41 41 41 41 41 41 41 41 41 41 41 1 1 1 41 31 31 156 120 41 41 1 1 31 31 41 41 1 1 1 41 108 109 83 84 2 1 41 41 41 41 31 31 1 1 
2 2 2 2 2 2 2 2 2 2 2 2 2 2 2 2 2 2 2 2 2 2 2 2 2 2 2 2 2 2 2 2 2 2 2 2 2 2 2 2 2 2 2 2 2 2 2 2 1 1 5 6 25 26 29 30 25 26 29 30 25 26 29 30 25 26 29 30 25 26 29 30 25 26 29 30 25 26 29 30 25 26 29 30 25 26 29 30 25 26 29 30 25 26 1 1 1 31 31 31 89 97 5 6 1 1 31 31 31 31 1 1 1 31 99 100 105 106 1 1 103 104 105 106 57 57 1 1 
2 2 2 2 2 2 2 2 2 2 2 2 2 2 2 2 2 2 2 2 2 2 2 2 2 2 2 2 2 2 2 2 2 2 2 2 2 2 2 2 2 2 2 2 2 2 2 2 1 1 5 6 159 160 5 6 159 160 5 6 159 160 5 6 159 160 5 6 159 160 5 6 159 160 5 6 159 160 5 6 159 160 5 6 159 160 5 6 159 160 5 6 159 160 1 1 1 31 87 88 41 41 5 6 1 1 31 31 87 88 1 1 1 31 41 41 161 112 1 1 91 92 162 163 164 41 1 1 
2 2 2 2 2 2 2 2 2 2 2 2 2 2 2 2 2 2 2 2 2 2 2 2 2 2 2 2 2 2 2 2 2 2 2 2 2 2 2 2 2 2 2 2 2 2 2 2 1 1 5 6 101 102 5 6 101 102 5 6 101 102 5 6 101 102 5 6 101 102 5 6 101 102 5 6 101 102 5 6 101 102 5 6 101 102 5 6 101 102 5 6 101 102 1 1 1 31 101 102 103 104 5 6 1 1 31 31 101 102 1 1 1 31 31 31 89 97 1 1 31 31 75 76 5 6 1 1 
2 2 2 2 2 2 2 2 2 2 2 2 2 2 2 2 2 2 2 2 2 2 2 2 2 2 2 2 2 2 2 2 2 2 2 2 2 2 2 2 2 2 2 2 2 2 2 2 1 1 5 6 93 94 5 6 85 86 5 6 93 94 5 6 93 94 5 6 95 96 5 6 85 86 5 6 93 94 5 6 85 86 5 6 93 94 5 6 85 86 5 6 93 94 1 1 1 31 95 96 91 92 5 6 1 1 31 31 85 86 1 1 1 31 31 31 41 41 41 41 31 73 76 31 5 6 1 1 
2 2 2 2 2 2 2 2 2 2 2 2 2 2 2 2 2 2 2 2 2 2 2 2 2 2 2 2 2 2 2 2 2 2 2 2 2 2 2 2 2 2 2 2 2 2 2 2 1 1 5 6 103 104 5 6 31 31 5 6 103 104 5 6 103 104 5 6 105 106 5 6 31 31 5 6 103 104 5 6 31 31 5 6 103 104 5 6 31 31 5 6 103 104 1 1 1 31 105 106 31 31 5 6 1 1 31 31 31 31 1 1 1 31 31 31 31 31 31 31 75 76 31 31 5 6 1 1 
2 2 2 2 2 2 2 2 2 2 2 2 2 2 2 2 2 2 2 2 2 2 2 2 2 2 2 2 2 2 2 2 2 2 2 2 2 2 2 2 2 2 2 2 2 2 2 2 1 1 165 166 167 168 165 166 57 57 165 166 167 168 165 166 167 168 165 166 169 170 165 166 57 57 165 166 167 168 165 166 57 57 165 166 167 168 165 166 57 57 165 166 167 168 1 1 1 57 169 170 57 57 165 166 1 1 57 57 57 57 1 1 1 31 171 172 31 31 31 31 173 31 80 81 174 175 1 1 
2 2 2 2 2 2 2 2 2 2 2 2 2 2 2 2 2 2 2 2 2 2 2 2 2 2 2 2 2 2 2 2 2 2 2 2 2 2 2 2 2 2 2 2 2 2 2 2 2 2 2 2 2 2 2 2 2 2 2 2 2 2 2 2 2 2 2 2 2 2 2 2 2 2 2 2 2 2 2 2 2 2 2 2 2 2 2 2 2 2 2 2 2 2 2 2 2 2 2 2 2 2 2 2 2 2 2 2 2 2 2 2 1 31 5 6 31 31 31 73 76 31 89 90 5 6 1 1 
2 2 2 2 2 2 2 2 2 2 2 2 2 2 2 2 2 2 2 2 2 2 2 2 2 2 2 2 2 2 2 2 2 2 2 2 2 2 2 2 2 2 2 2 2 2 2 2 2 2 2 2 2 2 2 2 2 2 2 2 2 2 2 2 2 2 2 2 2 2 2 2 2 2 2 2 2 2 2 2 2 2 2 2 2 2 2 2 2 2 2 2 2 2 2 2 2 2 2 2 2 2 2 2 2 2 2 2 2 2 2 2 1 31 5 6 31 31 75 76 31 31 103 104 5 6 1 1 
2 2 2 2 2 2 2 2 2 2 2 2 2 2 2 2 2 2 2 2 2 2 2 2 2 2 2 2 2 2 2 2 2 2 2 2 2 2 2 2 2 2 2 2 2 2 2 2 2 2 2 2 2 2 2 2 2 2 2 2 2 2 2 2 2 2 2 2 2 2 2 2 2 2 2 2 2 2 2 2 2 2 2 2 2 2 2 2 2 2 2 2 2 2 2 2 2 2 2 2 2 2 2 2 2 2 2 2 2 2 2 2 1 57 5 6 31 73 82 81 83 84 91 92 5 6 1 1 
2 2 2 2 2 2 2 2 2 2 2 2 2 2 2 2 2 2 2 2 2 2 2 2 2 2 2 2 2 2 2 2 2 2 2 2 2 2 2 2 2 2 2 2 2 2 2 2 2 2 2 2 2 2 2 2 2 2 2 2 2 2 2 2 2 2 2 2 2 2 2 2 2 2 2 2 2 2 2 2 2 2 2 2 2 2 2 2 2 2 2 2 2 2 2 2 2 2 2 2 2 2 2 2 2 2 2 2 2 2 2 2 1 1 60 61 98 79 89 97 99 100 31 31 5 6 1 1 
2 2 2 2 2 2 2 2 2 2 2 2 2 2 2 2 2 2 2 2 2 2 2 2 2 2 2 2 2 2 2 2 2 2 2 2 2 2 2 2 2 2 2 2 2 2 2 2 2 2 2 2 2 2 2 2 2 2 2 2 2 2 2 2 2 2 2 2 2 2 2 2 2 2 2 2 2 2 2 2 2 2 2 2 2 2 2 2 2 2 2 2 2 2 2 2 2 2 2 2 2 2 2 2 2 2 2 2 2 2 2 2 1 1 1 1 1 1 41 41 41 41 31 31 5 6 2 1 
2 2 2 2 2 2 2 2 2 2 2 2 2 2 2 2 2 2 2 2 2 2 2 2 2 2 2 2 2 2 2 2 2 2 2 2 2 2 2 2 2 2 2 2 2 2 2 2 2 2 2 2 2 2 2 2 2 2 2 2 2 2 2 2 2 2 2 2 2 2 2 2 2 2 2 2 2 2 2 2 2 2 2 2 2 2 2 2 2 2 2 2 2 2 2 2 2 2 2 2 2 2 2 2 2 2 2 2 2 2 2 2 1 1 5 6 103 104 31 31 31 31 57 57 60 61 2 1 
2 2 2 2 2 2 2 2 2 2 2 2 2 2 2 2 2 2 2 2 2 2 2 2 2 2 2 2 2 2 2 2 2 2 2 2 2 2 2 2 2 2 2 2 2 2 2 2 2 2 2 2 2 2 2 2 2 2 2 2 2 2 2 2 2 2 2 2 2 2 2 2 2 2 2 2 2 2 2 2 2 2 2 2 2 2 2 2 2 2 2 2 2 2 2 2 2 2 2 2 2 2 2 2 2 2 2 2 2 2 2 2 1 1 5 6 91 92 31 31 31 73 74 41 41 41 1 1 
2 2 2 2 2 2 2 2 2 2 2 2 2 2 2 2 2 2 2 2 2 2 2 2 2 2 2 2 2 2 2 2 2 2 2 2 2 2 2 2 2 2 2 2 2 2 2 2 2 2 2 2 2 2 2 2 2 2 2 2 2 2 2 2 2 2 2 2 2 2 2 2 2 2 2 2 2 2 2 2 2 2 2 2 2 2 2 2 2 2 2 2 2 2 2 2 2 2 2 2 2 2 2 2 2 2 2 2 2 2 2 2 47 48 5 6 31 31 31 31 75 76 31 31 105 106 1 1 
2 2 2 2 2 2 2 2 2 2 2 2 2 2 2 2 2 2 2 2 2 2 2 2 2 2 2 2 2 2 2 2 2 2 2 2 2 2 2 2 2 2 2 2 2 2 2 2 2 2 2 2 2 2 2 2 2 2 2 2 2 2 2 2 2 2 2 2 2 2 2 2 2 2 2 2 2 2 2 2 2 2 2 2 2 2 2 2 2 2 2 2 2 2 2 2 2 2 2 2 2 2 2 2 2 2 2 2 2 176 177 2 51 52 5 6 80 81 31 73 178 84 83 84 111 112 1 1 
2 2 2 2 2 2 2 2 2 2 2 2 2 2 2 2 2 2 2 2 2 2 2 2 2 2 2 2 2 2 2 2 2 2 2 2 2 2 2 2 2 2 2 2 2 2 2 2 2 2 2 2 2 2 2 2 2 2 2 2 2 2 2 2 2 2 2 2 2 2 2 2 2 2 2 2 2 2 2 2 2 2 2 2 2 2 2 2 2 2 2 2 2 2 2 2 2 2 2 2 2 2 2 2 2 2 2 2 2 2 2 2 62 63 60 61 89 97 98 179 99 100 99 100 89 97 1 1 
2 2 2 2 2 2 2 2 2 2 2 2 2 2 2 2 2 2 2 2 2 2 2 2 2 2 2 2 2 2 2 2 2 2 2 2 2 2 2 2 2 2 2 2 2 2 2 2 2 2 2 2 2 2 2 2 2 2 2 2 2 2 2 2 2 2 2 2 2 2 2 2 2 2 2 2 2 2 2 2 2 2 2 2 2 2 2 2 2 2 2 2 2 2 2 2 2 2 2 2 2 2 2 2 2 2 2 2 2 2 2 2 1 1 1 1 1 1 1 1 1 1 1 1 1 1 1 1 
