0 0 2048 4 0
0 0 1024 4 0
0 0 512 4 0
0 0 256 0 11 177 171 0 2 32 33 35 73 76 139 149
256 0 256 0 10 32 35 71 76 77 139 140 141 142 158
0 256 256 0 17 2 6 8 10 35 37 42 73 76 83 87 92 136 137 138 148 160
256 256 256 0 16 174 175 176 74 8 9 11 35 37 76 77 134 135 136 152 154
512 0 512 4 0
512 0 256 0 14 1 3 32 34 35 88 93 96 106 107 143 144 145 158
768 0 256 0 6 1 3 35 124 126 155
512 256 256 0 18 3 5 7 9 11 12 14 15 16 21 35 82 88 132 133 134 162 164
768 256 256 0 26 3 5 7 11 12 14 15 16 21 35 38 44 47 48 62 67 86 91 95 105 120 121 122 123 125 164
0 512 512 0 0
512 512 512 4 0
512 512 256 0 1 21
768 512 256 0 1 21
512 768 256 0 0
768 768 256 0 0
1024 0 1024 4 0
1024 0 512 4 0
1024 0 256 0 3 64 126 128
1280 0 256 0 10 4 36 64 65 81 130 131 153 156 161
1024 256 256 0 21 166 167 16 38 39 40 44 45 46 50 51 63 64 66 117 118 119 120 127 129 151
1280 256 256 0 20 4 17 22 36 40 41 43 46 49 51 64 65 66 81 114 115 116 117 161 163
1536 0 512 4 0
1536 0 256 0 1 4
1792 0 256 0 0
1536 256 256 0 17 165 4 17 18 19 22 23 49 52 53 54 61 111 112 113 157 163
1792 256 256 0 16 13 19 20 23 24 55 56 60 80 90 104 108 109 110 111 159
1024 512 512 4 0
1024 512 256 0 0
1280 512 256 0 1 22
1024 768 256 0 0
1280 768 256 0 0
1536 512 512 4 0
1536 512 256 0 9 18 22 23 25 26 27 29 31 54
1792 512 256 0 36 168 13 23 24 25 26 27 28 29 30 31 55 56 57 58 59 60 72 78 79 84 85 89 90 94 97 98 99 100 101 102 103 104 146 147 150
1536 768 256 0 0
1792 768 256 0 0
0 1024 1024 0 0
1024 1024 1024 0 0
