24 176
245 245 245 245 245 245 245 245 245 245 245 245 245 245 245 245 245 245 245 245 245 245 245 245 245 245 245 245 245 245 245 245 245 245 245 245 245 245 245 245 245 245 245 245 245 245 245 245 245 245 245 245 245 245 245 245 245 245 245 245 245 245 245 245 245 245 245 245 245 245 245 245 245 245 245 245 245 245 245 245 245 245 245 245 245 245 245 245 245 245 245 245 245 245 245 245 245 245 245 245 245 245 245 245 245 245 245 245 245 245 245 245 245 245 245 245 245 245 245 245 245 245 245 245 245 245 245 245 245 245 245 245 245 245 245 245 245 245 245 245 245 245 245 245 245 245 245 245 245 245 245 245 245 245 245 245 245 245 245 245 245 245 245 245 245 245 245 245 245 245 245 245 245 245 245 245 
1 2 3 4 51 52 1 2 1 2 3 4 51 52 1 2 1 2 3 4 5 6 1 2 1 2 3 4 51 52 1 2 53 54 3 4 51 52 53 54 1 2 1 2 1 2 1 2 3 4 51 52 95 95 3 4 55 56 1 2 1 2 53 54 3 4 53 54 3 4 53 54 3 4 53 54 3 4 1 2 53 54 1 2 55 56 55 56 1 2 95 95 3 4 16 245 245 16 16 16 16 16 3 4 16 16 16 16 16 16 16 16 64 65 16 16 64 65 16 16 16 16 16 16 16 16 245 245 1 2 1 2 3 4 55 56 1 2 3 4 53 54 1 2 3 4 51 52 53 54 25 26 1 2 73 2 3 4 25 26 94 1 73 2 3 4 25 26 1 2 5 6 53 54 33 245 
9 10 3 4 97 98 7 8 47 48 3 4 97 98 7 8 47 48 3 4 5 6 7 8 47 48 3 4 97 98 7 8 9 10 3 4 97 98 95 95 47 48 47 48 47 48 47 48 3 4 189 2 95 95 3 4 47 48 47 48 47 48 9 10 3 4 95 95 3 4 95 95 3 4 95 95 3 4 47 48 95 95 47 48 47 48 47 48 47 48 95 95 3 4 16 245 245 16 16 61 16 16 3 65 16 16 62 16 62 16 62 16 3 65 16 61 3 4 16 16 16 16 62 16 62 16 16 245 47 48 9 10 3 4 47 48 47 48 3 4 95 95 47 48 3 4 97 98 9 10 47 48 3 4 27 28 3 4 29 30 3 4 27 28 3 4 29 30 3 4 5 6 95 95 16 245 
55 56 3 4 143 1 53 54 1 2 3 4 143 1 53 54 1 2 3 4 51 52 53 54 1 2 3 4 143 94 53 54 55 56 3 4 97 2 95 95 1 2 1 2 1 2 1 2 3 4 235 48 95 95 3 4 1 2 1 2 1 2 55 56 3 4 95 95 3 4 95 95 3 4 95 95 3 4 1 2 95 95 1 2 1 2 1 2 1 2 95 95 3 4 16 245 245 16 16 107 16 16 64 65 16 16 16 16 16 16 16 16 64 65 16 107 3 4 16 16 16 16 16 16 16 16 16 245 1 2 55 56 3 4 1 2 1 2 3 4 95 95 1 2 3 4 143 1 55 56 1 2 3 4 73 94 3 4 25 26 3 4 73 2 3 4 25 26 3 4 51 52 95 95 16 245 
47 48 3 4 189 94 95 95 47 48 3 4 189 94 95 95 47 48 3 4 97 98 95 95 47 48 3 4 97 98 95 95 47 48 3 4 97 48 95 95 47 48 47 48 47 48 12 14 49 50 93 94 70 70 70 70 72 23 47 48 47 48 47 48 3 4 95 95 3 4 95 95 3 4 95 95 3 4 7 8 95 95 47 48 47 48 13 14 70 70 93 94 49 50 16 245 245 16 16 16 16 16 49 50 16 16 16 16 199 200 199 200 3 4 199 200 3 4 16 16 16 61 16 16 16 16 16 245 93 94 70 70 70 70 72 120 47 48 3 4 95 95 47 48 3 4 189 47 48 47 94 94 3 4 47 48 3 4 47 48 3 4 47 48 3 4 7 8 3 4 189 1 95 95 16 245 
1 2 3 4 235 1 95 95 1 2 3 4 235 1 95 95 1 2 3 4 143 1 95 95 1 2 3 4 143 1 95 95 1 2 3 4 97 2 95 95 1 2 1 2 1 12 58 245 245 245 245 245 245 245 245 245 118 119 23 2 1 2 1 2 3 4 95 95 3 4 95 95 3 4 95 95 3 4 53 54 95 95 1 2 1 13 58 245 245 245 245 245 245 245 245 245 245 245 245 245 245 245 245 245 16 16 16 16 245 246 245 246 3 4 245 246 3 4 16 16 16 107 245 245 245 245 245 245 245 245 245 245 245 245 118 119 23 1 3 4 95 95 1 2 3 4 235 1 1 2 1 2 3 4 1 2 3 4 1 2 3 4 1 2 3 4 53 54 3 4 235 2 95 95 16 245 
47 48 3 4 47 48 95 95 47 48 3 4 47 48 95 95 7 8 3 4 97 48 95 95 47 48 3 4 189 48 95 95 47 48 3 4 97 94 95 95 47 48 12 14 11 58 1 2 3 4 47 48 9 10 3 4 1 118 119 114 93 94 70 70 3 4 95 95 3 4 95 95 3 4 95 95 3 4 9 10 95 95 47 48 13 58 47 48 47 48 47 48 3 4 16 245 245 16 199 200 199 200 3 4 16 16 70 20 16 16 199 200 245 245 245 245 245 245 16 16 70 17 16 16 16 61 3 65 5 6 1 2 3 4 1 165 119 167 70 70 93 94 70 70 70 70 72 23 1 2 1 2 3 4 47 48 3 4 47 48 3 4 47 48 3 4 9 10 3 4 47 48 12 14 16 245 
1 2 3 4 1 2 95 95 1 2 3 4 1 2 95 95 53 54 3 4 143 2 95 95 1 2 3 4 235 2 95 95 1 2 3 4 97 94 95 95 94 12 58 245 245 245 117 94 3 4 1 2 55 56 3 4 2 7 245 245 245 245 245 245 3 4 95 95 3 4 95 95 3 4 95 95 3 4 55 56 95 95 1 13 58 1 2 1 1 2 1 2 3 4 16 245 245 16 245 246 245 246 3 4 245 245 245 19 20 16 245 246 245 245 245 245 3 65 245 245 245 19 20 16 16 107 3 65 51 52 1 2 3 4 1 2 245 245 245 245 245 245 245 245 245 245 118 119 23 1 1 2 3 4 1 2 3 4 1 2 3 4 1 2 3 4 55 56 3 4 1 12 58 245 245 245 
47 48 3 4 47 48 95 95 7 8 3 4 47 48 95 95 9 10 3 4 189 48 95 95 47 48 3 4 47 48 95 95 9 10 3 4 189 1 2 94 12 58 71 2 7 8 47 48 3 4 47 48 47 48 3 4 47 48 3 4 7 8 7 8 3 4 95 95 3 4 95 95 3 4 95 95 3 4 7 8 47 48 13 58 1 2 7 8 47 48 47 48 3 4 16 245 245 16 16 16 16 16 3 65 199 200 3 4 19 20 16 16 245 245 245 245 3 65 199 200 3 4 19 20 16 16 3 65 189 98 47 48 3 4 47 48 7 8 3 4 9 10 3 4 9 10 2 245 119 23 47 48 3 4 47 48 3 4 47 48 3 4 47 48 3 4 47 48 3 4 11 58 245 2 16 245 
1 2 3 4 1 2 95 95 53 54 3 4 1 2 95 95 55 56 3 4 235 2 95 95 1 2 3 4 1 2 95 95 55 56 3 4 235 47 48 12 58 71 47 48 53 54 1 2 3 4 1 2 1 2 3 4 1 2 3 4 53 54 53 54 3 4 95 95 3 4 95 95 3 4 95 95 3 4 53 54 1 13 58 47 47 48 53 54 1 2 1 2 3 4 16 245 245 16 16 16 16 16 64 65 245 246 3 4 16 19 20 16 245 245 245 245 64 65 245 246 3 4 16 19 20 16 3 65 235 48 1 2 3 4 1 2 53 54 3 4 55 56 3 4 55 56 47 48 245 119 23 1 3 4 1 2 3 4 1 2 3 4 1 2 3 4 1 2 3 4 245 245 47 48 16 245 
93 94 49 50 93 94 93 94 93 94 49 50 93 94 93 94 93 94 49 50 93 94 93 94 93 94 49 50 93 94 93 94 93 94 49 50 93 94 11 58 71 94 93 94 93 94 93 94 49 50 93 94 93 94 49 50 93 94 49 50 93 94 93 94 49 50 93 94 49 50 93 94 49 50 93 94 49 50 93 94 11 58 93 94 93 94 93 94 93 94 93 94 49 50 16 245 245 16 70 20 16 16 49 50 16 16 49 50 16 16 19 21 245 245 245 245 49 50 70 17 49 50 16 16 19 21 3 65 93 94 47 48 49 50 93 94 93 94 49 50 93 94 49 50 93 94 93 94 93 245 119 23 49 50 93 94 49 50 93 94 49 50 93 94 49 50 93 94 49 50 93 94 93 94 16 245 
245 245 245 245 245 245 245 245 245 245 245 245 245 245 245 245 245 245 245 245 245 245 245 245 245 245 245 245 245 245 245 245 245 245 245 245 245 245 245 245 245 245 245 245 245 245 245 245 245 245 245 245 245 245 245 245 245 245 245 245 245 245 245 245 245 245 245 245 245 245 245 245 245 245 245 245 245 245 245 245 245 245 245 245 245 245 245 245 245 245 245 245 245 245 245 245 245 245 245 63 245 245 245 245 245 245 245 245 245 245 245 245 245 245 245 245 245 245 245 63 245 245 245 245 245 245 245 245 245 245 245 245 245 245 245 245 245 245 245 245 245 245 245 245 245 245 245 245 245 245 245 245 245 245 245 245 245 245 245 245 245 245 245 245 245 245 245 245 245 245 245 245 245 245 245 245 
245 245 245 245 245 245 245 245 245 245 245 245 245 245 245 245 245 245 245 245 245 245 245 245 245 245 245 245 245 245 245 245 245 245 245 245 245 245 245 245 245 245 245 245 245 245 245 245 245 245 245 245 245 245 245 245 245 245 245 245 245 245 245 245 245 245 245 245 245 245 245 245 245 245 245 245 245 245 245 245 245 245 245 245 245 245 245 245 245 245 245 245 245 245 245 245 245 245 245 245 245 245 245 245 245 245 245 245 245 245 245 245 245 245 245 245 245 245 245 245 245 245 245 245 245 245 245 245 245 245 245 245 245 245 245 245 245 245 245 245 245 245 245 245 245 245 245 245 245 245 245 245 245 245 245 245 245 245 245 245 245 245 245 245 245 245 245 245 245 245 245 245 245 245 245 245 
245 245 245 245 245 245 245 245 245 245 245 245 245 245 245 245 245 245 245 245 245 245 245 245 245 245 245 245 245 245 245 245 245 245 245 245 245 245 245 245 245 245 245 245 245 245 245 245 245 245 245 245 245 245 245 245 245 245 245 245 245 245 245 245 245 245 245 245 245 245 245 245 245 245 245 245 245 245 245 245 245 245 245 245 245 245 245 245 245 245 245 245 245 245 245 245 3 4 16 108 109 245 3 4 245 245 245 245 3 4 245 245 3 4 245 245 3 4 16 19 109 245 245 245 3 4 3 65 245 245 245 245 245 245 245 245 245 245 245 245 245 245 245 245 245 245 245 245 245 245 245 245 245 245 245 245 245 245 245 245 245 245 245 245 245 245 245 245 245 245 245 245 245 245 245 245 
245 245 245 245 245 245 245 245 245 245 245 245 245 245 245 245 245 245 245 245 245 245 245 245 245 245 245 245 245 245 245 245 245 245 245 245 245 245 245 245 245 245 245 245 245 245 245 245 245 245 245 245 245 245 245 245 245 245 245 245 245 245 245 245 245 245 245 245 245 245 245 245 245 245 245 245 245 245 245 245 245 245 245 245 245 245 245 245 245 245 245 245 245 245 245 245 3 4 16 16 108 109 3 65 245 245 245 245 3 65 245 245 3 4 245 245 3 4 16 16 19 109 245 245 3 4 3 65 245 245 245 245 245 245 245 245 245 245 245 245 245 245 245 245 245 245 245 245 245 245 245 245 245 245 245 245 245 245 245 245 245 245 245 245 245 245 245 245 245 245 245 245 245 245 245 245 
245 245 245 245 245 245 245 245 245 245 245 245 245 245 245 245 245 245 245 245 245 245 245 245 245 245 245 245 245 245 245 245 245 245 245 245 245 245 245 245 245 245 245 245 245 245 245 245 245 245 245 245 245 245 245 245 245 245 245 245 245 245 245 245 245 245 245 245 245 245 245 245 245 245 245 245 245 245 245 245 245 245 245 245 245 245 245 245 245 245 245 245 245 245 245 245 3 4 16 16 16 108 64 65 245 245 245 245 64 65 245 245 3 4 245 245 3 4 16 16 16 19 109 245 3 4 3 65 245 245 245 245 245 245 245 245 245 245 245 245 245 245 245 245 245 245 245 245 245 245 245 245 245 245 245 245 245 245 245 245 245 245 245 245 245 245 245 245 245 245 245 245 245 245 245 245 
245 245 245 245 245 245 245 245 245 245 245 245 245 245 245 245 245 245 245 245 245 245 245 245 245 245 245 245 245 245 245 245 245 245 245 245 245 245 245 245 245 245 245 245 245 245 245 245 245 245 245 245 245 245 245 245 245 245 245 245 245 245 245 245 245 245 245 245 245 245 245 245 245 245 245 245 245 245 245 245 245 245 245 245 245 245 245 245 245 245 245 245 245 245 245 245 3 65 16 16 16 16 245 245 245 245 245 245 3 65 245 245 3 4 245 245 3 4 16 16 16 16 19 109 3 4 3 65 245 245 245 245 245 245 245 245 245 245 245 245 245 245 245 245 245 245 245 245 245 245 245 245 245 245 245 245 245 245 245 245 245 245 245 245 245 245 245 245 245 245 245 245 245 245 245 245 
245 245 245 245 245 245 245 245 245 245 245 245 245 245 245 245 245 245 245 245 245 245 245 245 245 245 245 245 245 245 245 245 245 245 245 245 245 245 245 245 245 245 245 245 245 245 245 245 245 245 245 245 245 245 245 245 245 245 245 245 245 245 245 245 245 245 245 245 245 245 245 245 245 245 245 245 245 245 245 245 245 245 245 245 245 245 245 245 245 245 245 245 245 245 245 245 64 65 16 16 16 16 3 4 245 245 245 245 64 65 245 245 3 4 245 245 3 4 16 16 16 16 16 19 3 4 3 65 245 245 245 245 245 245 245 245 245 245 245 245 245 245 245 245 245 245 245 245 245 245 245 245 245 245 245 245 245 245 245 245 245 245 245 245 245 245 245 245 245 245 245 245 245 245 245 245 
245 245 245 245 245 245 245 245 245 245 245 245 245 245 245 245 245 245 245 245 245 245 245 245 245 245 245 245 245 245 245 245 245 245 245 245 245 245 245 245 245 245 245 245 245 245 245 245 245 245 245 245 245 245 245 245 245 245 245 245 245 245 245 245 245 245 245 245 245 245 245 245 245 245 245 245 245 245 245 245 245 245 245 245 245 245 245 245 245 245 245 245 245 245 245 245 245 245 245 245 245 245 245 245 245 245 245 245 245 245 245 245 245 245 245 245 245 245 245 245 245 245 245 245 245 245 3 65 245 245 245 245 245 245 245 245 245 245 245 245 245 245 245 245 245 245 245 245 245 245 245 245 245 245 245 245 245 245 245 245 245 245 245 245 245 245 245 245 245 245 245 245 245 245 245 245 
245 245 245 245 245 245 245 245 245 245 245 245 245 245 245 245 245 245 245 245 245 245 245 245 245 245 245 245 245 245 245 245 245 245 245 245 245 245 245 245 245 245 245 245 245 245 245 245 245 245 245 245 245 245 245 245 245 245 245 245 245 245 245 245 245 245 245 245 245 245 245 245 245 245 245 245 245 245 245 245 245 245 245 245 245 245 245 245 245 245 245 245 245 245 245 245 3 4 153 154 153 154 3 4 66 67 153 154 3 4 245 245 3 4 245 245 3 4 153 154 153 154 153 154 3 4 3 65 245 245 245 245 245 245 245 245 245 245 245 245 245 245 245 245 245 245 245 245 245 245 245 245 245 245 245 245 245 245 245 245 245 245 245 245 245 245 245 245 245 245 245 245 245 245 245 245 
245 245 245 245 245 245 245 245 245 245 245 245 245 245 245 245 245 245 245 245 245 245 245 245 245 245 245 245 245 245 245 245 245 245 245 245 245 245 245 245 245 245 245 245 245 245 245 245 245 245 245 245 245 245 245 245 245 245 245 245 245 245 245 245 245 245 245 245 245 245 245 245 245 245 245 245 245 245 245 245 245 245 245 245 245 245 245 245 245 245 245 245 245 245 245 245 3 65 245 245 245 245 3 65 112 113 15 15 3 4 245 158 3 4 245 158 3 4 15 15 245 158 245 245 3 4 245 245 245 245 245 245 245 245 245 245 245 245 245 245 245 245 245 245 245 245 245 245 245 245 245 245 245 245 245 245 245 245 245 245 245 245 245 245 245 245 245 245 245 245 245 245 245 245 245 245 
245 245 245 245 245 245 245 245 245 245 245 245 245 245 245 245 245 245 245 245 245 245 245 245 245 245 245 245 245 245 245 245 245 245 245 245 245 245 245 245 245 245 245 245 245 245 245 245 245 245 245 245 245 245 245 245 245 245 245 245 245 245 245 245 245 245 245 245 245 245 245 245 245 245 245 245 245 245 245 245 245 245 245 245 245 245 245 245 245 245 245 245 245 245 245 245 64 65 245 245 245 245 64 65 245 245 15 15 3 4 153 154 3 4 153 154 3 4 15 15 153 154 245 245 3 4 153 154 245 245 245 245 245 245 245 245 245 245 245 245 245 245 245 245 245 245 245 245 245 245 245 245 245 245 245 245 245 245 245 245 245 245 245 245 245 245 245 245 245 245 245 245 245 245 245 245 
245 245 245 245 245 245 245 245 245 245 245 245 245 245 245 245 245 245 245 245 245 245 245 245 245 245 245 245 245 245 245 245 245 245 245 245 245 245 245 245 245 245 245 245 245 245 245 245 245 245 245 245 245 245 245 245 245 245 245 245 245 245 245 245 245 245 245 245 245 245 245 245 245 245 245 245 245 245 245 245 245 245 245 245 245 245 245 245 245 245 245 245 245 245 245 245 110 111 110 111 110 111 110 111 110 111 110 111 110 111 110 111 110 111 110 111 110 111 110 111 110 111 110 111 245 245 110 111 245 245 245 245 245 245 245 245 245 245 245 245 245 245 245 245 245 245 245 245 245 245 245 245 245 245 245 245 245 245 245 245 245 245 245 245 245 245 245 245 245 245 245 245 245 245 245 245 
245 245 245 245 245 245 245 245 245 245 245 245 245 245 245 245 245 245 245 245 245 245 245 245 245 245 245 245 245 245 245 245 245 245 245 245 245 245 245 245 245 245 245 245 245 245 245 245 245 245 245 245 245 245 245 245 245 245 245 245 245 245 245 245 245 245 245 245 245 245 245 245 245 245 245 245 245 245 245 245 245 245 245 245 245 245 245 245 245 245 245 245 245 245 245 245 156 157 156 157 156 157 156 157 156 157 156 157 156 157 156 157 156 157 156 157 156 157 156 157 156 157 156 157 3 4 156 157 245 245 245 245 245 245 245 245 245 245 245 245 245 245 245 245 245 245 245 245 245 245 245 245 245 245 245 245 245 245 245 245 245 245 245 245 245 245 245 245 245 245 245 245 245 245 245 245
