0 0 3584 4 0
0 0 1792 4 0
0 0 896 4 0
0 0 448 4 0
0 0 224 0 1 20
224 0 224 0 0
0 224 224 0 21 20 25 26 35 36 37 42 53 58 59 64 66 67 68 69 70 71 85 125 126 127
224 224 224 0 15 26 30 37 38 39 54 60 72 90 100 101 127 128 129 130
448 0 448 4 0
448 0 224 0 0
672 0 224 0 1 21
448 224 224 0 20 27 28 30 32 39 40 41 55 61 72 73 74 75 91 102 103 131 132 133 134
672 224 224 0 12 21 23 29 31 32 33 40 82 134 135 136 137
0 448 448 4 0
0 448 224 0 13 42 43 45 48 49 51 52 66 67 88 89 124 125
224 448 224 0 10 46 47 51 86 87 121 122 123 124 154
0 672 224 0 0
224 672 224 0 0
448 448 448 4 0
448 448 224 0 8 47 50 51 84 118 119 120 149
672 448 224 0 5 44 50 51 118 153
448 672 224 0 0
672 672 224 0 0
896 0 896 4 0
896 0 448 4 0
896 0 224 0 0
1120 0 224 0 5 10 11 63 80 81
896 224 224 0 2 31 112
1120 224 224 0 4 31 56 113 150
1344 0 448 4 0
1344 0 224 0 11 11 17 22 65 79 80 81 104 140 141 151
1568 0 224 0 5 11 12 95 105 141
1344 224 224 0 16 22 24 31 34 56 57 62 65 76 77 78 79 92 114 138 139
1568 224 224 0 0
896 448 448 0 0
1344 448 448 0 0
0 896 896 0 0
896 896 896 0 0
1792 0 1792 4 0
1792 0 896 4 0
1792 0 448 4 0
1792 0 224 0 11 0 2 3 7 8 12 13 96 106 142 143
2016 0 224 0 7 0 2 3 8 83 143 144
1792 224 224 0 1 8
2016 224 224 0 1 8
2240 0 448 4 0
2240 0 224 0 4 3 97 107 108
2464 0 224 0 4 3 97 109 110
2240 224 224 0 0
2464 224 224 0 0
1792 448 448 0 0
2240 448 448 0 0
2688 0 896 4 0
2688 0 448 4 0
2688 0 224 0 7 3 4 5 93 94 98 111
2912 0 224 0 4 5 6 93 115
2688 224 224 0 0
2912 224 224 0 0
3136 0 448 4 0
3136 0 224 0 12 1 6 9 14 15 18 19 99 115 116 145 152
3360 0 224 0 11 156 9 15 19 116 117 146 147 148 152 155
3136 224 224 0 2 14 19
3360 224 224 0 1 19
2688 448 448 0 0
3136 448 448 0 0
1792 896 896 0 0
2688 896 896 0 0
0 1792 1792 0 0
1792 1792 1792 0 0
